01x10101010101010101011010101010101010101
02x00000000000000000000000000000000000000
03x10000000000000000000000000000000000001
04x00000000000000000000000000000000000000
05x10000000000000000000000000000000000001
06x00000000100000000000000000000100000000
07x10000000011000000000000000011000000001
08x00000000000110000000000001100000000000
09x10000000000001100000000110000000000001
10x00000000000000011000011000000000000000
11x10000000000000000100100000000000000001
12x00000000000000000000000000000000000000
13x10000000000000000100100000000000000001
14x00000000000000011000011000000000000000
15x10000000000001100000000110000000000001
16x00000000000110000000000001100000000000
17x10000000011000000000000000011000000001
18x00000000100000000000000000000100000000
19x10000000000000000000000000000000000001
20x00000000000000000000000000000000000000
21x10000000000000000000000000000000000001
22x00000000000000000000000000000000000000
23x10101010101010101011010101010101010101