x01x10101010101010101011010101010101010101
x02x00000000000000000000000000000000000000
x03x10000000000000000000000000000000000001
x04x00000000000000000000000000000000000000
x05x10000000000000000000000000000000000001
x06x00000000100000000000000000000100000000
x07x10000000011000000000000000011000000001
x08x00000000000110000000000001100000000000
x09x10000000000001100000000110000000000001
x10x00000000000000011000011000000000000000
x11x10000000000000000100100000000000000001
x12x00000000000000000000000000000000000000
x13x10000000000000000100100000000000000001
x14x00000000000000011000011000000000000000
x15x10000000000001100000000110000000000001
x16x00000000000110000000000001100000000000
x17x10000000011000000000000000011000000001
x18x00000000100000000000000000000100000000
x19x10000000000000000000000000000000000001
x20x00000000000000000000000000000000000000
x21x10000000000000000000000000000000000001
x22x00000000000000000000000000000000000000
x23x10101010101010101011010101010101010101