00x10101010101010101011010101010101010101
01x00000000000000000000000000000000000000
02x10000000000000000000000000000000000001
03x00000000000000000000000000000000000000
04x10000000000000000000000000000000000001
05x00000000100000000000000000000100000000
06x10000000011000000000000000011000000001
07x00000000000110000000000001100000000000
08x10000000000001100000000110000000000001
09x00000000000000011000011000000000000000
10x10000000000000000100100000000000000001
11x00000000000000000000000000000000000000
12x10000000000000000100100000000000000001
13x00000000000000011000011000000000000000
14x10000000000001100000000110000000000001
15x00000000000110000000000001100000000000
16x10000000011000000000000000011000000001
17x00000000100000000000000000000100000000
18x10000000000000000000000000000000000001
19x00000000000000000000000000000000000000
20x10000000000000000000000000000000000001
21x00000000000000000000000000000000000000
22x10101010101010101011010101010101010101